用いる	を を から として を は が も を として が に は を を を 	道具を 記号処理を 従来から 手法として ルールを 白物家電では 制御技術が 他社も 知的制御を 売り文句として 名称が 大々的に これは 神経ネットワークのみを 行動型システムを 人工知能を 
研究する	を が に を 	『知能』を 知的制御が 盛んに 問題を 
指す	を 	一分野」を 
代わる	を に 	知的行動を 人間に 
行う	に を に を が に を は を を に を に を に を は は は から に で を で を を を は まで を に が は で が は を をめぐって を を を を まで を 	コンピューターに 経験を 元に 学習を 研究が 盛んに コンテンツ生成を エイダ・ラブレスは 開発を 来談者中心療法を 1956年に 処理を Webに 知的処理を コンピュータに 知的処理を 1990年代には 概念は 産業応用は 地上から 全世界的に 民間企業主導で 投資を 無報酬で 探索を 研究を 脳シミュレーションを 中国では 歩行者まで 監視を 人工知能に 監視社会・管理社会化が 11月には 国際連合で 公式専門家会議が 米国・中国・ロシアは 開発競争を 軍事利用をめぐって 試験を 「メイヴン計画」を 裁判を 意思疎通を 「これまで 議論を 
する	も を と に を を と は も は を と と と まで と を は に を と は と は を に は も と を と は を と を と 	研究分野」とも 記述を 主体と 計算機に 役割を ことを 基本と Web開発者にとっては 現在も 普及は エキスパートシステムを 専門と 有望と 必要だと これまで 困難と 実験を 4分の3は 2022年までに 投資を 予防拘禁していると 処理能力は 必要と 2017年には これを ものに 中国は 主張も 実用化してると AIを 神と 哲学者は 話を 考えだと 勘違いを 確かでしょう」と 
述べる	は に は と は と は は も と と 	佐藤理史は 次のように 釈徹宗は 不明瞭になってきています。」と 田中一之は 専門家ではない」と これは 須藤は 次のようにも 不可能です」と 大きいのかもしれません」と 
実現する	を で 	知的能力を コンピュータ上で 
ある	は が も は に も が が も は も が は が は が に において が は て に でも が が に対して は で が も も に が は が が に か が 	応用例は 画像認識等が ことも 差は 記号的明示性に 手法も ものが ものが ことも 場合には 問題も 必要が ニューロファジィは 利点が 向上には 限界が 関係に 言語処理において 進展が 中国では 比較して 環境に 幹部でも 可能性が 懸念が 達したのに対して Amazonは 6割で バイアスが 主張も ことも 状態に 可能性が アメリカ側では 必要が 文化が それ自体に 何か 問題が 
模倣する	を を 	推論・判断を カウンセラーを 
解析する	を で 	画像データを 人工知能で 
検出・	て を 	解析して パターンを 
命名する	に で により 	1956年に ダートマス会議で ジョン・マッカーシーにより 
使う	でも は によって のに を も を は が を を を 	意味あいでも ニューラルネットワークは バックプロパゲーションアルゴリズムによって スケジューリングするのに AIを 社会インフラにも 専用プログラムを プログラミング言語は Pythonが AIを 自律無人艇を 日常的言語を 
呼ぶ	も と は と と と と と は を と と も に を 	思考ルーチンも 「エキスパートシステム」と 人工知能は 機械学習と エキスパートシステムと ゲンギスと ディープラーニングと 一人と メディアなどは 政治体制を 「AI独裁」と スウォームと 際も 同様に 波紋を 
出す	が に を を に により が 	（人工無脳）が 引き合いに 精度を 開発禁止令を 2012年に 企業家らにより 公開書簡が 
持つ	が に が から が が を を を を が を 	人間が 暗黙に 松下電器が 1985年頃から 人間が 対象が 機構を 「脳」を 認識能力を 現実味を 「哲学者が 興味を 
なる	が と は と が と に で と に が に が と は が に と と は で に から は が と が と は に が で は は と に は に が にとって は は に は に 	記述が 問題と 麻雀では 最先端技術と 解決が 壁と 1950年代に 日本で ブームと ものに ニューロファジィが ブームに 特徴が 利用可能と 末には 白物家電が 大多数に ニュースと 計算資源と 2017年には 世界中で 話題に 2013年から 論文数では 中国が 世界一と 数学知識が 必要と 人権侵害は 国際問題に マサチューセッツ工科大学が 精度で Megviiは 際は Amazonと 論争に 変化は ことに 開発競争が 人類にとって ものとは ドナルド・トランプ大統領は 事態に 「これは 愚痴に 
困難視	が 	利用が 
知る	も 	アプローチも 
集める	が を は を に を を 	「サポートベクターマシン」が 注目を ファジィは 注目を 急速に 注目を 天才児を 
表現する	を に を として は と に 	知性を 機械的に オントロジーを （ファジィルールとして 使命は こと」と 抽象的に 
超える	を を を における を 	流行を 米国を 人間を 議論における 脳を 
浸透する	に 	社会に 
行く	て 	浸透して 
導入する	を は を を 	ディープラーニングを アラン・チューリングは 「チューリングテスト」を 「ファランクスCIWS」を 
破る	も 	プレイヤーも 
到達する	が として に 	「MicrosoftSuphx(SuperPhoenix)」が AIとして 十段に 
繰り返す	を 	学習を 
基づく	に に に に に に 	経験に 知識工学に データに これに （AI）に 自由連想に 
関係する	と と 	ソフトコンピューティングと シンギュラリティと 
統合する	を 	これらを 
作る	を も 	知的システムを 褒賞制度も 
なす	も 	試みも 
生成する	を に を通して 	統計的学習を 元に 生成規則を通して 
上回る	で を が を で を 	領域で 人工知能を コストが 投資全額を 読解テストで 人間を 
でる	が 	派生が 
活躍する	で 	各分野で 
だす	が で を 	ディープラーニングが 分野で 成果を 
加える	に 	ことに 
見せる	において を を 	生成技術において 進化を 振る舞いを 
広がる	は が 	森正弥は 応用分野が 
始まる	も に が は から 	応用も 同年に 第三次AIブームが 哲学は （スコレー）から 
提唱する	が と に は を は が が に に で が も が が が 	身体が 機械であると 時代に 知能には （身体性）を 1998年には XMLが セマンティック・ウェブが 2010年に 2010年に 英国エコノミスト誌で 用語が 概念も ロドニー・ブルックスが 理論が カプセルネットワークが 
製作する	は を 	ブレーズ・パスカルは 機械式計算機を 
もたらす	は に を 	アルフレッド・ノース・ホワイトヘッドは 形式論理に 革命を 
出版する	を を 	『数学原理』を 『パーセプトロン』を 
発表する	は を に は を は を を と て は も が を は と は が を 	ウォルター・ピッツは 論文を 1943年に レイ・カーツワイルは 説を 2013年には 「ディファレンシャブル・ニューラル・コンピューター」を 研究を 勝利したと 更新して 5月には 映像も Microsoftが 共同研究を Googleは 設置すると Googleは 倫理委員会が 解散を 
内在する	に 	「神経活動に 
題する	と 	論理計算」と 
築く	を 	基礎を 
出る	に関して が 	AIに関して 成果が 
作り出す	は で を 	ジョン・マッカーシーは 会議で 用語を 
開発する	を は を を に は を を が を は を は を が 	プログラミング言語を アラン・カルメラウアーは プログラミング言語を 乗り物を 1992年に IBMは バックギャモン専用コンピュータ・TDギャモンを ニューロファジィ制御を 研究チームが （AGI）を MITリンカーン研究所は アーキテクチャを Googleは ソフトウェアを 研究チームが 
可能に	を が を 	テストを データが 「ワンショット学習」を 
構築する	を は を て が によって を 	ジョセフ・ワイゼンバウムはを テッド・ショートリッフェは ルールベースシステムを リバースエンジニアリングして 中国が AIによって 監視国家を 
使用する	として を は を 	用語として Wikipediaなどを AIプログラムは ファジィ制御を 
創立する	として を 	分野として 道)」を 
示す	は で を は て を を は は を で に が 	ジョエル・モーゼスは プログラム中で パワーを シーモア・パパートは 出版して 限界を パワーを アンソニー゠レバンドウスキーは レバンドウスキーは 振る舞いを 観察結果で 1931年に ゲーデルが 
走行する	を に 	コースを 自律的に 
上げる	は で が を も を 	1990年代は 分野で アプリケーションが 成果を ことも 成果を 
匹敵する	に に 	世界チャンピオンに 核開発に 
打つ	に を 	5月に ガルリ・カスパロフを 
敗れる	は で に が 	8月には オセロで オセロ専用コンピュータ・ロジステロに 村上健が 
スケジューリングする	において を 	湾岸戦争において ユニットを 
省く	によって 	これによって 
明らかに	を は 	ことを 違いは 
発生する	は も 	日本では 成果も 
啓蒙する	が に 	甘利俊一（日本学士院会員）らが 精力的に 
指摘する	が を 	ブラックボックス性が ことを 
適用する	から を 	ここから 意味付けを 
適す	に 	アプリケーション別に 
開始する	が を 	試みが 研究を 
付加する	に を 	データに 意味を 
規格化	を に 	方法を 国際的に 
含む	は も は も を 	規格には OWLも 倫理委員会には 人物も 要素を 
分かる	が が が に 	ことが ことが 識別したのかが 明確に 
完了する	に が 	前半に 規格化が 
見合う	に 	開発工数に 
見出せる	が 	メリットが 
流行する	は に が が 	日本においては 後に ニューロファジィが ニューラルネットワークが 
進む	が から は として に が から 	研究が 能力限界から 改善は 遅々として 軍事・民間共に 研究開発が ディープラーニングから 
直面する	に 	フレーム問題に 
激変する	を 	在り方を 
至る	に まで は は 	AIに 1992年まで 日本は 実現には 
終焉する	は 	ブームは 
入る	に に で が に に は に に 	1980年代に 2010年代に コストで 計算リソースが 手に 2019年に 目標は 2022年までに 世界トップ4に 
提案する	が により が 	エキスパートシステムが 研究チームにより 深層化手法が 
立ち上がる	も 	AIベンチャーも 
生まれる	から によって 	流行から 脳スキャンによって 
挙げる	として が が は を 	プロジェクトとして 第五世代コンピュータが 懸念が 井口尊仁は プロジェクトを 
費やす	として を 	国家プロジェクトとして 570億円を 
進める	を も が 	研究を 影響についても 研究が 
異なる	で が も 	専門家間で 解釈が 哲学も 
行える	が 	ルール化が 
解釈する	を で 	命令を 機構で 
実行する	て に 	解釈して 高速に 
見つかる	で が 	意味で 応用先が 
克服する	を 	問題を 
学習する	を から 	特徴を 環境から 
分類する	て 	学習して 
融合する	を が 	2つを アナログが 
迎える	が に を で を 	手法が 中心に ブームを 程度で 限界を 
合わせる	に 	高級路線に 
増やす	も を に 	白物家電製品でも 種類を 大幅に 
最適化	に を に を 	元に 運転を 柔軟に 運転を 
発売する	が を 	モデルが 製品を 
取得する	に が を 	2018年までに 日本が 特許を 
発展する	より に 	当時より 分野に 
意識する	は は は 	利用者には ブーム後は 一般には 
巻き込む	も 	一般人も 
言える	も と 	前史とも 社会現象と 
活かす	を に 	曖昧さを 制御に 
漕ぎ着ける	に に 	1日に 発売に 
収集する	も で から 	従来よりも センサーで 携帯電話などから 
マッチする	という が も 	ファジィ制御という 導入が 高級路線にも 
関わる	も も も に が 	制御技術であるにも 努力にも 高速化にも 標的選択支援アルゴリズムに AI研究者が 
選ぶ	で が 	金賞で 「ファジィ」が 
巻き起こす	は て を 	松下電器は 成功して ブームを 
自動化	を 	チューニングを 
突破する	を 	限界を 
評価する	て で 	突破して 学会で 
成功する	も が で に で に 	応用にも 中華人民共和国が 開発競争で 6月に 自律飛行実験で 飛行実験に 
受ける	を を を と で を 	成功を 普及を 動向を 拒否すると 整合性で 追及を 
売る	の 	白物家電の 
付与する	は は は が 	製品名では 分類としては 運転モードでは 名称が 
モデル化	を で に 	対象を 数式で 客観的に 
難しい	は は 	作業は 場合は 
比較する	と と 	現代制御等と 欧米と 
抑える	を 	開発工数を 
できる	を は 	柔軟性を ことは 
改善する	を 	制御を 
与える	が に が に は に を 	データが 潤沢に 人工知能が 雇用などに 軍用AI開発は 政界に 危機感を 
無くなる	は 	進展は 
搭載する	を に を を に に に 	知的制御を ロボットに （天網）を 監視カメラを 1(哨戒機)のように 戦闘指揮システムに 支援用に 
去る	は 	ブームは 
実証する	は に が 	現在では 十分に 安定性が 
設計する	が 	人間が 
利活用	を 	表現する）を 
超越する	が で を 	人工知能が 点で 人間を 
担う	を 	進歩を 
変革する	を 	世界を 
訪れる	が も 	（シンギュラリティ）が 2045年にも 
扱う	を を を の を に は を も を 	データを タスクのみを タスクを 学問の 「大きな」問題を 哲学的・統一的に 天文学では 〔哲学的〕問題を 物理学でも 問題を 
整備する	が が 	環境が 環境が 
前進する	が 	研究が 
勝利する	で に に に 	練習戦で 人間に プロ囲碁棋士に 一方的に 
果たす	に で が を 	2012年に 画像処理コンテストで チームが 精度改善を 
優勝する	で に が 	上で 2012年に ディープラーニングが 
挑む	で に に 	「東ロボくん」で 模擬試験に 作成に 
臨む	が 	受験生が 
解読する	を 	問題を 
先立つ	に 	特異点に 
近づく	により が 	進歩により 生産コストが 
向ける	に に に 	実現に 実用化に 開発支援に 
続ける	を 	研究を 
展開する	で を が 	中で 理論を 研究開発競争が 
進行する	が 	開発が 
利用する	は は は を が で を に 	2010年代には 自動化は （UCAVは 深層学習を 中国が 政治目的で 人工知能を 選別攻撃などに 
留まる	に 	ものに 
登場する	が 	理論が 
先行する	が 	知が 
行動する	に 	ように 
作成する	に が 	10月に 米DeepMind社が 
注目する	が は が が 	「AlphaGo」が 勝利して以降は 手法が OODAループが 
導き出す	を を 	関連性を ものを 
解決する	を 	記号接地問題(シンボルグラウンディング問題)を 
付ける	で に を 	画像処理コンテストで 手法に 圧倒的大差を 
受け止める	は 	概念は 
立つ	が を 	プロジェクトが ニューラ・リンク社を 
*する	を 	脳を 
組み合わせる	を 	機械学習を 
動かす	で を 	仮想空間で モデルを 
学ぶ	を に 	ことを 高速に 
考える	と は と 	不可能と 脳は 困難」と 
再現する	を 	身体知を 
挑戦する	に 	（人工意識）に 
いる	も も 	研究者も 著名人も 
出現する	が が 	ビッグデータが インターネットが 
寄せる	が に を 	企業が 活用に 関心を 
実用化	が に は 	ITインフラが 急速に 中国は 
解決できる	を に 	組み合わせ最適化問題を リアルタイムに 
目立つ	も が 	ニュース番組でも 報道が 
進化する	に 	急速に 
取る	に対して が を 	人工知能に対して 人間が 遅れを 
接続する	を に 	脳を 機械に 
研究開発	を 	ブレイン・マシン・インターフェースを 
公表する	を 	ことを 
予測する	が 	事が 
学習できる	は により 	10月には ジェフリー・ヒントンにより 
含める	まで を 	位置関係まで ウィトゲンシュタインを 
よる	に に に に に に に に に に 	提言に 教授やなどに 米国政府に 日経新聞調べに 内田樹に ダニエル・デネットに 前掲書に 田中に フランセーンに ことか』に 
活用する	を で を 	AIを 人工知能で ビッグデータを 
寄与できる	で に 	事で 社会変革に 
分析する	と 	寄与できると 
実装する	が を 	OpenAIが 好奇心を 
いう	と と 	人間らしいと 入ることだと 
識別する	を 	推論を 
経る	を を を 	段階を ウイグル族を 法的手続きを 
連携する	と 	アレン脳科学研究所と 
処理する	を 	データを 
管理する	が 	Googleが 
達す	は に で は に 	データ量は 1Zettaバイトに 9割超で IBMは 8割に 
始める	とも を 	マックスプランク研究所とも 共同研究を 
再	から を 	電子顕微鏡写真から 神経回路を 
推進する	は で を で を 	中国では 官民一体で 研究開発を 日本で 研究開発を 
位置づける	から を に 	第13次5カ年計画から AIを 国家プロジェクトに 
立ち上げる	も 	脳研究プロジェクトとしても 
投じる	は に が 	教育機関では 開発に 215億ユーロが 
リードする	も において が 	齊藤元章も 開発において 中国が 
主張する	を と と 	可能性を 加速すると 実現できないと 
占める	が 	中国が 
独占する	も が を 	大会でも 中国勢が 上位を 
取り上げる	は が を 	台湾系アメリカ人科学者のは メディアなどが 言葉を 
握る	が で を 	中国が AIで 覇権を 
招致する	は を 	フランス大統領エマニュエル・マクロンは 富士通などを 
支出する	で を 	5年で （約1600億円）を 
宣言する	と 	支出すると 
開く	を に 	AI研究所を パリに 
決定する	も 	連携も 
設立する	を 	AI機関を 
重要と	も 	知識も 
否定する	は を は と 	『人工知能は 可能性を 際は モデリング」と 
於く	に 	超えるか』内に 
起こす	に対して を 	人間に対して 反乱を 
鳴らす	を に を に は に を 	警鐘を ことに 警鐘を 11月に マーク・エスパー国防長官は ことに 警鐘を 
変わる	は が 	教授は 既成概念が 
併せ持つ	を 	弾圧を 
代表する	に に 	中国に 社会信用システムに 
抑圧する	で を 	人工知能で 人権を 
埋め込む	に 	帽子に 
監視する	から を で 	センサーから 感情を 人工知能で 
推し進める	が 	プロジェクトが 
予防拘禁	は に 	新疆ウイグル自治区では 新疆ウイグル再教育キャンプに 
選別する	を で 	個人情報を 人種プロファイリングで 
犯す	で も を 	6月時点で 約1万5千人も 犯罪を 
報じる	が 	内部文書であるが 
送る	が を に 	コンピュータが 人間を 強制収容所に 
恐れる	を 	監視社会化を 
起きる	が 	香港民主化デモが 
破壊する	は が に 	際は スマート街灯が 市民に 
輸出する	は を に 	中国は AI監視技術を 世界各国に 
主導する	を通じて が も 	（ITU）を通じて 中国が 国際標準化も 
懸念する	から が から について 	ことから ことが 人権団体などから ことについて 
拡散する	が に で を に 	人権侵害が 世界に 中東で 無人攻撃機を 大量に 
決める	て を を 	活用して 適性を 軍事バランスを 
固定化	を 	格差を 
繋がる	に 	ことに 
施行する	は が 	欧州連合では EU一般データ保護規則が 
認める	を 	差別を 
試みる	を 	自動化を 
破壊できる	は により を 	アメリカ海軍は ガトリング砲により 対艦ミサイルを 
所有する	は を 	イスラエル軍は 「アイアンドーム」を 
射殺する	は て を 	境界線には 稼働させて 人間を 
自動検知	を 	標的を 
稼働する	を 	サムソンRCWSを 
生む	は を 	AIは 軍事能力を 
変える	を 	展開を 
一変する	を 	戦争を 
介す	から を 	観点から 判断を 
勝ち残る	に が 	人工知能に 人間が 
加速する	により は 	軍事利用により 不安定化は 
開催する	に で 	2015年に ブエノスアイレスで 
操る	を により を 	銃火器を ボット投稿により 世論を 
続く	に 	核兵器に 
とらえる	と 	革命と 
実用可能	は に 	一部は 数年以内に 
求める	は を 	4月には 禁止を 
盛り込む	に は も は 	8月に 同会議は 採択するも 法的拘束力は 
めぐる	を 	運用を 
採択する	を 	国際ルールを 
更新する	を 	記録を 
爆撃する	を 	都市を 
進展する	は で が に 	6月には 統合運用）で 中国が 急速に 
追い付く	に 	アメリカに 
備える	に 	将来に 
協力する	で に が に に 	設立などで 中国人民解放軍に Googleが 軍事利用に 中国政府に 
非難する	と を 	協力していると Googleを 
開放する	は て は に 	CEOサンダー・ピチャイは 面談して 成果は 人々に 
面談する	と 	トランプ大統領と 
限る	に 	中国に 
釈明する	と 	開放されていると 
暴露する	は が に に 	アメリカでは ことが 社員に 同様に 
拒否する	は 	人権侵害は 
誓う	が 	Googleが 
攻撃する	て で に を 	拡散させて AIで 自律的に 個人を 
販売する	も 	ドローン兵器も 
なりすます	たり で 	攻撃したり ディープフェイクで 
指導する	を で 	人工知能プロジェクトを 倫理面で 
構成する	に で 	ために 哲学者・政策立案者・経済学者・テクノロジスト等で 
設置する	を 	AI倫理委員会を 
支持する	を 	反科学・反マイノリティ・地球温暖化懐疑論等を 
要請する	は を 	Google社員らは 解任を 
機能できる	に 	「期待どおりに 
判明する	が 	ことが 
吸収する	を に 	東洋哲学を AIに 
応じる	に 	テーマに 
見いだす	に を 	ものに 霊的存在を 
語る	に を で を を 	立石従寛に 『科学を 日常的言語で 「宇宙」を 『科学を 
通じる	は も 	アニミズム的人工知能論は 哲学塾東洋哲学篇』にも 
やる	を に 	悟りを AIに 
促進する	を 	実現を 
良い	を通して を 	崇拝を通して 社会を 
貢献する	に 	ことに 
報道する	は 	海外メディアは 
関連付ける	と 	歴史などと 
盗用する	が を 	レバンドウスキーが 機密情報を 
訴える	を 	ことを 
発言する	に対し と は と 	（トラビス゠カラニック）に対し 征服するんだ」と 須藤は つくのでしょうか？」と 
征服する	は を 	我々は 世界を 
不明瞭に	も 	線引きも 
言う	が において は と と は 	発明家レイ・カーツワイルが ことか』において 野家啓一は 特異点と 進歩」だと 須藤は 
提起する	が 	哲学者ジョン・サールが 
実現できる	が によって 	意識が 形式論理システムによって 
「	と 	科学と 
解明する	を 	問題を 
関連する	に 	（コンピュータ科学）・人工知能研究開発等に 
批判する	は が 	フランシス・クリックは 多くが 
残す	も を 	何も 成果を 
過ぎる	は に 	哲学は 学問・科学に 
賛同する	に 	クリックに 
ため息まじる	の 	私の 
思う	は と は 	思想家というのは 『暇』だと 明らかになったとは 
伝える	が 	アリストテレスが 
違う	は が は 	科学とは 定義が 物理学者とは 
信用する	を 	哲学者を 
見る	が から は も 	ディラックが 観点から 間違いは 入門書などにも 
理解する	さえ 	概念さえ 
創る	は 	『人工知能は 
伴う	に 	発展に 
論じる	が で に 	哲学が 一部で 哲学的に 
記す	は と 	前掲書は 定義できていない」と 
定義できる	が 	言明自体が 
捉える	を として 	脳を 「デジタル情報処理システム」として 
起こる	は は に 	シンギュラリティは 誤解・誤用は 一般に 
存在する	は が 	神経膜では 「ノイズ」が 
生み出す	によって が 	アナログ量によって 「カオス」が 
記述する	を で 	状況を デジタルで 
書く	について が 	不完全性定理について 哲学者が 
書店販売	に 	頃に 
酷評する	は によって 	本は 専門誌によって 
乱用する	も 	神学でも 
整理する	が 	問題が 
言及する	について 	天文学について 
返す	は と 	須藤は あるのでしょうか」と 
定義する	を に 	言葉を 具体的に 
大きい	は 	違いというのは 
答える	で は 	対談で 伊勢田は 
つく	か が は 	何か 決着が 「決着は 
